Month,AustralianPort,ForeignPort,Country,Passengers_In,Passengers_Out,Passengers_Total,Year,Month_num
19-Jan,Brisbane,Abu Dhabi,United Arab Emirates,9089,6821,15910,2019,1
19-Jan,Brisbane,Apia,Western Samoa,1869,1124,2993,2019,1
19-Jan,Brisbane,Auckland,New Zealand,45349,41864,87213,2019,1
19-Jan,Brisbane,Bangkok,Thailand,4669,4106,8775,2019,1
19-Jan,Brisbane,Beijing,China,1624,1523,3147,2019,1
19-Jan,Brisbane,Christchurch,New Zealand,13640,13062,26702,2019,1
19-Jan,Brisbane,Denpasar,Indonesia,19604,15898,35502,2019,1
19-Jan,Brisbane,Dubai,United Arab Emirates,28992,20958,49950,2019,1
19-Jan,Brisbane,Dunedin,New Zealand,1700,1700,3400,2019,1
19-Jan,Brisbane,Espiritu Santo,Vanuatu,480,397,877,2019,1
19-Jan,Brisbane,Guangzhou,China,8474,8052,16526,2019,1
19-Jan,Brisbane,Hong Kong,Hong Kong (SAR),19645,15091,34736,2019,1
19-Jan,Brisbane,Honiara,Solomon Islands,2256,2022,4278,2019,1
19-Jan,Brisbane,Honolulu,USA,3522,3009,6531,2019,1
19-Jan,Brisbane,Kuala Lumpur,Malaysia,6473,4483,10956,2019,1
19-Jan,Brisbane,Los Angeles,USA,18805,15872,34677,2019,1
19-Jan,Brisbane,Manila,Philippines,3307,2711,6018,2019,1
19-Jan,Brisbane,Nadi,Fiji,10162,7527,17689,2019,1
19-Jan,Brisbane,Nauru,Nauru,664,771,1435,2019,1
19-Jan,Brisbane,Noumea,New Caledonia,3461,3283,6744,2019,1
19-Jan,Brisbane,Port Moresby,Papua New Guinea,7417,8515,15932,2019,1
19-Jan,Brisbane,Port Vila,Vanuatu,4141,3321,7462,2019,1
19-Jan,Brisbane,Queenstown,New Zealand,4518,3622,8140,2019,1
19-Jan,Brisbane,Seoul,Korea,7987,6087,14074,2019,1
19-Jan,Brisbane,Shanghai,China,6667,5513,12180,2019,1
19-Jan,Brisbane,Shenzhen,China,1489,1178,2667,2019,1
19-Jan,Brisbane,Singapore,Singapore,44898,37858,82756,2019,1
19-Jan,Brisbane,Taipei,Taiwan,13275,11255,24530,2019,1
19-Jan,Brisbane,Tokyo,Japan,8264,7808,16072,2019,1
19-Jan,Brisbane,Vancouver,Canada,7307,5907,13214,2019,1
19-Jan,Brisbane,Wellington,New Zealand,7566,7282,14848,2019,1
19-Feb,Brisbane,Abu Dhabi,United Arab Emirates,5897,4562,10459,2019,2
19-Feb,Brisbane,Apia,Western Samoa,892,802,1694,2019,2
19-Feb,Brisbane,Auckland,New Zealand,33419,35909,69328,2019,2
19-Feb,Brisbane,Bangkok,Thailand,4295,3875,8170,2019,2
19-Feb,Brisbane,Beijing,China,3118,2870,5988,2019,2
19-Feb,Brisbane,Christchurch,New Zealand,10528,10539,21067,2019,2
19-Feb,Brisbane,Denpasar,Indonesia,14729,14792,29521,2019,2
19-Feb,Brisbane,Dubai,United Arab Emirates,16870,12626,29496,2019,2
19-Feb,Brisbane,Dunedin,New Zealand,1205,1223,2428,2019,2
19-Feb,Brisbane,Espiritu Santo,Vanuatu,72,187,259,2019,2
19-Feb,Brisbane,Guangzhou,China,7546,6746,14292,2019,2
19-Feb,Brisbane,Hong Kong,Hong Kong (SAR),16523,14284,30807,2019,2
19-Feb,Brisbane,Honiara,Solomon Islands,1606,1606,3212,2019,2
19-Feb,Brisbane,Honolulu,USA,2315,2019,4334,2019,2
19-Feb,Brisbane,Kuala Lumpur,Malaysia,4855,3332,8187,2019,2
19-Feb,Brisbane,Los Angeles,USA,14212,11227,25439,2019,2
19-Feb,Brisbane,Manila,Philippines,2469,2113,4582,2019,2
19-Feb,Brisbane,Nadi,Fiji,5185,5360,10545,2019,2
19-Feb,Brisbane,Nauru,Nauru,812,461,1273,2019,2
19-Feb,Brisbane,Noumea,New Caledonia,2130,2726,4856,2019,2
19-Feb,Brisbane,Port Moresby,Papua New Guinea,6984,6754,13738,2019,2
19-Feb,Brisbane,Port Vila,Vanuatu,1956,2218,4174,2019,2
19-Feb,Brisbane,Queenstown,New Zealand,2538,2703,5241,2019,2
19-Feb,Brisbane,Seoul,Korea,6530,5728,12258,2019,2
19-Feb,Brisbane,Shanghai,China,6004,4733,10737,2019,2
19-Feb,Brisbane,Shenzhen,China,1448,1350,2798,2019,2
19-Feb,Brisbane,Singapore,Singapore,38259,29641,67900,2019,2
19-Feb,Brisbane,Taipei,Taiwan,10329,8889,19218,2019,2
19-Feb,Brisbane,Tokyo,Japan,7809,7055,14864,2019,2
19-Feb,Brisbane,Vancouver,Canada,6283,4455,10738,2019,2
19-Feb,Brisbane,Wellington,New Zealand,6142,6208,12350,2019,2
19-Mar,Brisbane,Abu Dhabi,United Arab Emirates,4069,6104,10173,2019,3
19-Mar,Brisbane,Apia,Western Samoa,1006,889,1895,2019,3
19-Mar,Brisbane,Auckland,New Zealand,40738,38959,79697,2019,3
19-Mar,Brisbane,Bangkok,Thailand,3659,4053,7712,2019,3
19-Mar,Brisbane,Beijing,China,2040,1970,4010,2019,3
19-Mar,Brisbane,Christchurch,New Zealand,12414,11088,23502,2019,3
19-Mar,Brisbane,Denpasar,Indonesia,15683,17235,32918,2019,3
19-Mar,Brisbane,Dubai,United Arab Emirates,14027,18713,32740,2019,3
19-Mar,Brisbane,Dunedin,New Zealand,1470,1227,2697,2019,3
19-Mar,Brisbane,Espiritu Santo,Vanuatu,326,259,585,2019,3
19-Mar,Brisbane,Guangzhou,China,6274,6150,12424,2019,3
19-Mar,Brisbane,Hong Kong,Hong Kong (SAR),14131,14983,29114,2019,3
19-Mar,Brisbane,Honiara,Solomon Islands,2010,1858,3868,2019,3
19-Mar,Brisbane,Honolulu,USA,2290,2655,4945,2019,3
19-Mar,Brisbane,Kuala Lumpur,Malaysia,3303,2679,5982,2019,3
19-Mar,Brisbane,Los Angeles,USA,13994,14812,28806,2019,3
19-Mar,Brisbane,Manila,Philippines,2548,2309,4857,2019,3
19-Mar,Brisbane,Nadi,Fiji,6667,7554,14221,2019,3
19-Mar,Brisbane,Nauru,Nauru,832,663,1495,2019,3
19-Mar,Brisbane,Noumea,New Caledonia,2090,2275,4365,2019,3
19-Mar,Brisbane,Port Moresby,Papua New Guinea,7789,7464,15253,2019,3
19-Mar,Brisbane,Port Vila,Vanuatu,2630,2882,5512,2019,3
19-Mar,Brisbane,Queenstown,New Zealand,3283,2940,6223,2019,3
19-Mar,Brisbane,Seoul,Korea,4024,4796,8820,2019,3
19-Mar,Brisbane,Shanghai,China,2702,2714,5416,2019,3
19-Mar,Brisbane,Shenzhen,China,1197,1148,2345,2019,3
19-Mar,Brisbane,Singapore,Singapore,35165,33662,68827,2019,3
19-Mar,Brisbane,Taipei,Taiwan,9113,10090,19203,2019,3
19-Mar,Brisbane,Tokyo,Japan,7909,7908,15817,2019,3
19-Mar,Brisbane,Vancouver,Canada,5521,6098,11619,2019,3
19-Mar,Brisbane,Wellington,New Zealand,7304,6340,13644,2019,3
19-Apr,Brisbane,Abu Dhabi,United Arab Emirates,6921,8665,15586,2019,4
19-Apr,Brisbane,Apia,Western Samoa,1032,1047,2079,2019,4
19-Apr,Brisbane,Auckland,New Zealand,43044,40398,83442,2019,4
19-Apr,Brisbane,Bangkok,Thailand,3962,4361,8323,2019,4
19-Apr,Brisbane,Christchurch,New Zealand,12572,12467,25039,2019,4
19-Apr,Brisbane,Denpasar,Indonesia,15443,17134,32577,2019,4
19-Apr,Brisbane,Dubai,United Arab Emirates,14756,22072,36828,2019,4
19-Apr,Brisbane,Dunedin,New Zealand,2253,1997,4250,2019,4
19-Apr,Brisbane,Espiritu Santo,Vanuatu,482,459,941,2019,4
19-Apr,Brisbane,Guangzhou,China,7657,7730,15387,2019,4
19-Apr,Brisbane,Hong Kong,Hong Kong (SAR),16565,16541,33106,2019,4
19-Apr,Brisbane,Honiara,Solomon Islands,2099,1879,3978,2019,4
19-Apr,Brisbane,Honolulu,USA,2885,3142,6027,2019,4
19-Apr,Brisbane,Kuala Lumpur,Malaysia,3892,3621,7513,2019,4
19-Apr,Brisbane,Los Angeles,USA,14133,16654,30787,2019,4
19-Apr,Brisbane,Manila,Philippines,3169,3287,6456,2019,4
19-Apr,Brisbane,Nadi,Fiji,8386,8673,17059,2019,4
19-Apr,Brisbane,Nauru,Nauru,715,799,1514,2019,4
19-Apr,Brisbane,Noumea,New Caledonia,2671,2486,5157,2019,4
19-Apr,Brisbane,Port Moresby,Papua New Guinea,8138,8471,16609,2019,4
19-Apr,Brisbane,Port Vila,Vanuatu,3535,3704,7239,2019,4
19-Apr,Brisbane,Queenstown,New Zealand,3585,3181,6766,2019,4
19-Apr,Brisbane,Seoul,Korea,3093,4102,7195,2019,4
19-Apr,Brisbane,Shanghai,China,3303,3406,6709,2019,4
19-Apr,Brisbane,Shenzhen,China,1294,1628,2922,2019,4
19-Apr,Brisbane,Singapore,Singapore,38796,40040,78836,2019,4
19-Apr,Brisbane,Taipei,Taiwan,8896,10134,19030,2019,4
19-Apr,Brisbane,Tokyo,Japan,7163,7145,14308,2019,4
19-Apr,Brisbane,Vancouver,Canada,4721,6633,11354,2019,4
19-Apr,Brisbane,Wellington,New Zealand,8125,6840,14965,2019,4
19-May,Brisbane,Abu Dhabi,United Arab Emirates,5409,8919,14328,2019,5
19-May,Brisbane,Apia,Western Samoa,1287,1201,2488,2019,5
19-May,Brisbane,Auckland,New Zealand,38816,37640,76456,2019,5
19-May,Brisbane,Bangkok,Thailand,3987,4629,8616,2019,5
19-May,Brisbane,Christchurch,New Zealand,10595,9560,20155,2019,5
19-May,Brisbane,Denpasar,Indonesia,17736,18796,36532,2019,5
19-May,Brisbane,Dubai,United Arab Emirates,14474,19455,33929,2019,5
19-May,Brisbane,Dunedin,New Zealand,1893,1660,3553,2019,5
19-May,Brisbane,Espiritu Santo,Vanuatu,394,362,756,2019,5
19-May,Brisbane,Guangzhou,China,7302,7173,14475,2019,5
19-May,Brisbane,Hong Kong,Hong Kong (SAR),13478,14602,28080,2019,5
19-May,Brisbane,Honiara,Solomon Islands,2101,1955,4056,2019,5
19-May,Brisbane,Honolulu,USA,3179,3147,6326,2019,5
19-May,Brisbane,Kuala Lumpur,Malaysia,3562,3147,6709,2019,5
19-May,Brisbane,Los Angeles,USA,15783,15621,31404,2019,5
19-May,Brisbane,Manila,Philippines,3122,2387,5509,2019,5
19-May,Brisbane,Munda,Solomon Islands,0,252,252,2019,5
19-May,Brisbane,Nadi,Fiji,8440,8276,16716,2019,5
19-May,Brisbane,Nauru,Nauru,764,552,1316,2019,5
19-May,Brisbane,Noumea,New Caledonia,2155,2039,4194,2019,5
19-May,Brisbane,Port Moresby,Papua New Guinea,7680,7283,14963,2019,5
19-May,Brisbane,Port Vila,Vanuatu,2950,2904,5854,2019,5
19-May,Brisbane,Queenstown,New Zealand,1565,1527,3092,2019,5
19-May,Brisbane,Seoul,Korea,3371,3644,7015,2019,5
19-May,Brisbane,Shanghai,China,2934,2976,5910,2019,5
19-May,Brisbane,Shenzhen,China,1153,1124,2277,2019,5
19-May,Brisbane,Singapore,Singapore,38103,37469,75572,2019,5
19-May,Brisbane,Taipei,Taiwan,8772,8611,17383,2019,5
19-May,Brisbane,Tokyo,Japan,6686,6755,13441,2019,5
19-May,Brisbane,Vancouver,Canada,4954,7056,12010,2019,5
19-May,Brisbane,Wellington,New Zealand,6728,5922,12650,2019,5
19-Jun,Brisbane,Abu Dhabi,United Arab Emirates,6847,8211,15058,2019,6
19-Jun,Brisbane,Apia,Western Samoa,1268,1449,2717,2019,6
19-Jun,Brisbane,Auckland,New Zealand,35198,36878,72076,2019,6
19-Jun,Brisbane,Bangkok,Thailand,4130,5325,9455,2019,6
19-Jun,Brisbane,Christchurch,New Zealand,9773,10414,20187,2019,6
19-Jun,Brisbane,Denpasar,Indonesia,17358,18669,36027,2019,6
19-Jun,Brisbane,Dubai,United Arab Emirates,19952,26200,46152,2019,6
19-Jun,Brisbane,Dunedin,New Zealand,1885,1915,3800,2019,6
19-Jun,Brisbane,Espiritu Santo,Vanuatu,326,369,695,2019,6
19-Jun,Brisbane,Guangzhou,China,7316,7669,14985,2019,6
19-Jun,Brisbane,Hong Kong,Hong Kong (SAR),14755,17029,31784,2019,6
19-Jun,Brisbane,Honiara,Solomon Islands,2309,2728,5037,2019,6
19-Jun,Brisbane,Honolulu,USA,2549,2923,5472,2019,6
19-Jun,Brisbane,Kuala Lumpur,Malaysia,3220,3973,7193,2019,6
19-Jun,Brisbane,Los Angeles,USA,15666,16556,32222,2019,6
19-Jun,Brisbane,Manila,Philippines,2686,2761,5447,2019,6
19-Jun,Brisbane,Munda,Solomon Islands,0,151,151,2019,6
19-Jun,Brisbane,Nadi,Fiji,7589,8703,16292,2019,6
19-Jun,Brisbane,Nauru,Nauru,534,298,832,2019,6
19-Jun,Brisbane,Noumea,New Caledonia,2325,2796,5121,2019,6
19-Jun,Brisbane,Port Moresby,Papua New Guinea,7617,8163,15780,2019,6
19-Jun,Brisbane,Port Vila,Vanuatu,3080,3584,6664,2019,6
19-Jun,Brisbane,Queenstown,New Zealand,3231,4064,7295,2019,6
19-Jun,Brisbane,Seoul,Korea,3888,4119,8007,2019,6
19-Jun,Brisbane,Shanghai,China,2780,3135,5915,2019,6
19-Jun,Brisbane,Shenzhen,China,1385,1503,2888,2019,6
19-Jun,Brisbane,Singapore,Singapore,38137,43816,81953,2019,6
19-Jun,Brisbane,Taipei,Taiwan,8103,9396,17499,2019,6
19-Jun,Brisbane,Tokyo,Japan,5958,5789,11747,2019,6
19-Jun,Brisbane,Vancouver,Canada,5672,6853,12525,2019,6
19-Jun,Brisbane,Wellington,New Zealand,6688,6321,13009,2019,6