20-Jan,Melbourne,Abu Dhabi,United Arab Emirates,18820,16074,34894,2020,1
20-Jan,Melbourne,Auckland,New Zealand,63859,61744,125603,2020,1
20-Jan,Melbourne,Bandar Seri Begawan,Brunei,6979,6136,13115,2020,1
20-Jan,Melbourne,Bangkok,Thailand,22547,20854,43401,2020,1
20-Jan,Melbourne,Beijing,China,7625,7073,14698,2020,1
20-Jan,Melbourne,Changsha,China,283,463,746,2020,1
20-Jan,Melbourne,Chengdu,China,2015,1678,3693,2020,1
20-Jan,Melbourne,Chicago,USA,0,0,0,2020,1
20-Jan,Melbourne,Chongqing,China,2745,2288,5033,2020,1
20-Jan,Melbourne,Christchurch,New Zealand,21379,20714,42093,2020,1
20-Jan,Melbourne,Colombo,Sri Lanka,8376,7715,16091,2020,1
20-Jan,Melbourne,Denpasar,Indonesia,36127,30287,66414,2020,1
20-Jan,Melbourne,Doha,Qatar,15300,14074,29374,2020,1
20-Jan,Melbourne,Dubai,United Arab Emirates,32413,26865,59278,2020,1
20-Jan,Melbourne,Guangzhou,China,27525,23906,51431,2020,1
20-Jan,Melbourne,Guiyang,China,1510,1325,2835,2020,1
20-Jan,Melbourne,Haikou,China,2011,1571,3582,2020,1
20-Jan,Melbourne,Hangzhou,China,1437,1248,2685,2020,1
20-Jan,Melbourne,Ho Chi Minh City,Vietnam,12292,11795,24087,2020,1
20-Jan,Melbourne,Hong Kong,Hong Kong (SAR),42680,34463,77143,2020,1
20-Jan,Melbourne,Honolulu,USA,3622,3303,6925,2020,1
20-Jan,Melbourne,Jakarta,Indonesia,3940,3743,7683,2020,1
20-Jan,Melbourne,Kuala Lumpur,Malaysia,40468,36694,77162,2020,1
20-Jan,Melbourne,London,UK,1202,1170,2372,2020,1
20-Jan,Melbourne,Los Angeles,USA,30388,26826,57214,2020,1
20-Jan,Melbourne,Manila,Philippines,13535,11457,24992,2020,1
20-Jan,Melbourne,Nadi,Fiji,7655,6562,14217,2020,1
20-Jan,Melbourne,New Delhi,India,3109,3057,6166,2020,1
20-Jan,Melbourne,New York,USA,0,0,0,2020,1
20-Jan,Melbourne,Noumea,New Caledonia,1866,1567,3433,2020,1
20-Jan,Melbourne,Phuket,Thailand,5289,4780,10069,2020,1
20-Jan,Melbourne,Port Vila,Vanuatu,1847,1257,3104,2020,1
20-Jan,Melbourne,Qingdao,China,2466,2272,4738,2020,1
20-Jan,Melbourne,Queenstown,New Zealand,11914,11600,23514,2020,1
20-Jan,Melbourne,San Francisco,USA,6662,5597,12259,2020,1
20-Jan,Melbourne,Santiago,Chile,2388,2155,4543,2020,1
20-Jan,Melbourne,Sapporo,Japan,0,0,0,2020,1
20-Jan,Melbourne,Seoul,Korea,151,47,198,2020,1
20-Jan,Melbourne,Shanghai,China,17437,14156,31593,2020,1
20-Jan,Melbourne,Shenzhen,China,3056,2408,5464,2020,1
20-Jan,Melbourne,Singapore,Singapore,80960,69314,150274,2020,1
20-Jan,Melbourne,Taipei,Taiwan,5208,4834,10042,2020,1
20-Jan,Melbourne,Tokyo,Japan,14028,13260,27288,2020,1
20-Jan,Melbourne,Vancouver,Canada,4472,3948,8420,2020,1
20-Jan,Melbourne,Wellington,New Zealand,11103,10149,21252,2020,1
20-Jan,Melbourne,Xiamen,China,3091,3125,6216,2020,1
20-Feb,Melbourne,Abu Dhabi,United Arab Emirates,16273,11751,28024,2020,2
20-Feb,Melbourne,Auckland,New Zealand,46245,47846,94091,2020,2
20-Feb,Melbourne,Bandar Seri Begawan,Brunei,5828,3397,9225,2020,2
20-Feb,Melbourne,Bangkok,Thailand,20519,17382,37901,2020,2
20-Feb,Melbourne,Beijing,China,744,918,1662,2020,2
20-Feb,Melbourne,Chengdu,China,318,391,709,2020,2
20-Feb,Melbourne,Chicago,USA,0,0,0,2020,2
20-Feb,Melbourne,Christchurch,New Zealand,16612,17320,33932,2020,2
20-Feb,Melbourne,Colombo,Sri Lanka,7867,5739,13606,2020,2
20-Feb,Melbourne,Denpasar,Indonesia,25807,22918,48725,2020,2
20-Feb,Melbourne,Doha,Qatar,13538,12340,25878,2020,2
20-Feb,Melbourne,Dubai,United Arab Emirates,27167,18174,45341,2020,2
20-Feb,Melbourne,Guangzhou,China,4460,3985,8445,2020,2
20-Feb,Melbourne,Guiyang,China,363,656,1019,2020,2
20-Feb,Melbourne,Ho Chi Minh City,Vietnam,12313,6974,19287,2020,2
20-Feb,Melbourne,Hong Kong,Hong Kong (SAR),22853,16666,39519,2020,2
20-Feb,Melbourne,Honolulu,USA,3461,2987,6448,2020,2
20-Feb,Melbourne,Jakarta,Indonesia,3647,2554,6201,2020,2
20-Feb,Melbourne,Kuala Lumpur,Malaysia,37709,22687,60396,2020,2
20-Feb,Melbourne,London,UK,952,892,1844,2020,2
20-Feb,Melbourne,Los Angeles,USA,21826,19109,40935,2020,2
20-Feb,Melbourne,Manila,Philippines,10333,7214,17547,2020,2
20-Feb,Melbourne,Nadi,Fiji,4024,3838,7862,2020,2
20-Feb,Melbourne,New Delhi,India,3276,2849,6125,2020,2
20-Feb,Melbourne,New York,USA,0,0,0,2020,2
20-Feb,Melbourne,Noumea,New Caledonia,861,1295,2156,2020,2
20-Feb,Melbourne,Phuket,Thailand,4874,3870,8744,2020,2
20-Feb,Melbourne,Port Vila,Vanuatu,336,259,595,2020,2
20-Feb,Melbourne,Qingdao,China,237,201,438,2020,2
20-Feb,Melbourne,Queenstown,New Zealand,8188,8135,16323,2020,2
20-Feb,Melbourne,San Francisco,USA,5419,5163,10582,2020,2
20-Feb,Melbourne,Santiago,Chile,2224,2178,4402,2020,2
20-Feb,Melbourne,Seoul,Korea,264,35,299,2020,2
20-Feb,Melbourne,Shanghai,China,5425,5899,11324,2020,2
20-Feb,Melbourne,Singapore,Singapore,62364,41738,104102,2020,2
20-Feb,Melbourne,Taipei,Taiwan,4223,3538,7761,2020,2
20-Feb,Melbourne,Tokyo,Japan,13231,11814,25045,2020,2
20-Feb,Melbourne,Vancouver,Canada,4237,3563,7800,2020,2
20-Feb,Melbourne,Wellington,New Zealand,9306,8530,17836,2020,2
20-Mar,Melbourne,Abu Dhabi,United Arab Emirates,9291,8801,18092,2020,3
20-Mar,Melbourne,Auckland,New Zealand,33176,29300,62476,2020,3
20-Mar,Melbourne,Bandar Seri Begawan,Brunei,1916,2016,3932,2020,3
20-Mar,Melbourne,Bangkok,Thailand,14599,10038,24637,2020,3
20-Mar,Melbourne,Beijing,China,174,985,1159,2020,3
20-Mar,Melbourne,Chicago,USA,0,0,0,2020,3
20-Mar,Melbourne,Christchurch,New Zealand,12538,9676,22214,2020,3
20-Mar,Melbourne,Colombo,Sri Lanka,6277,3898,10175,2020,3
20-Mar,Melbourne,Denpasar,Indonesia,19275,13059,32334,2020,3
20-Mar,Melbourne,Doha,Qatar,9214,14493,23707,2020,3
20-Mar,Melbourne,Dubai,United Arab Emirates,19474,18424,37898,2020,3
20-Mar,Melbourne,Guangzhou,China,749,6218,6967,2020,3
20-Mar,Melbourne,Ho Chi Minh City,Vietnam,7620,5545,13165,2020,3
20-Mar,Melbourne,Hong Kong,Hong Kong (SAR),6258,9666,15924,2020,3
20-Mar,Melbourne,Honolulu,USA,1408,1173,2581,2020,3
20-Mar,Melbourne,Jakarta,Indonesia,2147,2414,4561,2020,3
20-Mar,Melbourne,Kuala Lumpur,Malaysia,18263,12432,30695,2020,3
20-Mar,Melbourne,London,UK,1076,889,1965,2020,3
20-Mar,Melbourne,Los Angeles,USA,13924,14123,28047,2020,3
20-Mar,Melbourne,Manila,Philippines,5189,2979,8168,2020,3
20-Mar,Melbourne,Nadi,Fiji,3092,2487,5579,2020,3
20-Mar,Melbourne,New Delhi,India,2020,1952,3972,2020,3
20-Mar,Melbourne,New York,USA,0,0,0,2020,3
20-Mar,Melbourne,Noumea,New Caledonia,430,371,801,2020,3
20-Mar,Melbourne,Phuket,Thailand,2469,1615,4084,2020,3
20-Mar,Melbourne,Port Vila,Vanuatu,400,377,777,2020,3
20-Mar,Melbourne,Queenstown,New Zealand,6213,4544,10757,2020,3
20-Mar,Melbourne,San Francisco,USA,2996,3623,6619,2020,3
20-Mar,Melbourne,Santiago,Chile,1663,1825,3488,2020,3
20-Mar,Melbourne,Seoul,Korea,54,14,68,2020,3
20-Mar,Melbourne,Shanghai,China,544,5999,6543,2020,3
20-Mar,Melbourne,Singapore,Singapore,34316,26638,60954,2020,3
20-Mar,Melbourne,Taipei,Taiwan,1459,2495,3954,2020,3
20-Mar,Melbourne,Tokyo,Japan,5413,4997,10410,2020,3
20-Mar,Melbourne,Vancouver,Canada,3137,3613,6750,2020,3
20-Mar,Melbourne,Wellington,New Zealand,6055,5436,11491,2020,3
20-Mar,Melbourne,Xiamen,China,57,812,869,2020,3
20-Apr,Melbourne,Abu Dhabi,United Arab Emirates,232,60,292,2020,4
20-Apr,Melbourne,Anchorage,USA,0,0,0,2020,4
20-Apr,Melbourne,Auckland,New Zealand,373,574,947,2020,4
20-Apr,Melbourne,Bandar Seri Begawan,Brunei,6,44,50,2020,4
20-Apr,Melbourne,Bangkok,Thailand,0,0,0,2020,4
20-Apr,Melbourne,Buenos Aires,Argentina,181,65,246,2020,4
20-Apr,Melbourne,Chengdu,China,0,0,0,2020,4
20-Apr,Melbourne,Chicago,USA,0,0,0,2020,4
20-Apr,Melbourne,Cincinnati,USA,0,0,0,2020,4
20-Apr,Melbourne,Colombo,Sri Lanka,430,0,430,2020,4
20-Apr,Melbourne,Doha,Qatar,2020,9415,11435,2020,4
20-Apr,Melbourne,Dubai,United Arab Emirates,0,0,0,2020,4
20-Apr,Melbourne,Guangzhou,China,0,0,0,2020,4
20-Apr,Melbourne,Ho Chi Minh City,Vietnam,111,0,111,2020,4
20-Apr,Melbourne,Hong Kong,Hong Kong (SAR),31,107,138,2020,4
20-Apr,Melbourne,Honolulu,USA,0,0,0,2020,4
20-Apr,Melbourne,Jakarta,Indonesia,240,404,644,2020,4
20-Apr,Melbourne,Johannesburg,South Africa,183,179,362,2020,4
20-Apr,Melbourne,Kuala Lumpur,Malaysia,195,814,1009,2020,4
20-Apr,Melbourne,London,UK,307,121,428,2020,4
20-Apr,Melbourne,Los Angeles,USA,0,0,0,2020,4
20-Apr,Melbourne,Manila,Philippines,610,197,807,2020,4
20-Apr,Melbourne,Nadi,Fiji,0,84,84,2020,4
20-Apr,Melbourne,New York,USA,0,0,0,2020,4
20-Apr,Melbourne,San Francisco,USA,212,0,212,2020,4
20-Apr,Melbourne,Santiago,Chile,278,27,305,2020,4
20-Apr,Melbourne,Shanghai,China,0,0,0,2020,4
20-Apr,Melbourne,Shenzhen,China,0,0,0,2020,4
20-Apr,Melbourne,Singapore,Singapore,0,0,0,2020,4
20-Apr,Melbourne,Taipei,Taiwan,39,264,303,2020,4
20-May,Melbourne,Abu Dhabi,United Arab Emirates,185,97,282,2020,5
20-May,Melbourne,Anchorage,USA,0,0,0,2020,5
20-May,Melbourne,Auckland,New Zealand,868,1102,1970,2020,5
20-May,Melbourne,Bandar Seri Begawan,Brunei,6,29,35,2020,5
20-May,Melbourne,Bangkok,Thailand,181,259,440,2020,5
20-May,Melbourne,Chicago,USA,0,0,0,2020,5
20-May,Melbourne,Cincinnati,USA,0,0,0,2020,5
20-May,Melbourne,Colombo,Sri Lanka,483,701,1184,2020,5
20-May,Melbourne,Doha,Qatar,1830,3832,5662,2020,5
20-May,Melbourne,Dubai,United Arab Emirates,53,70,123,2020,5
20-May,Melbourne,Guangzhou,China,0,0,0,2020,5
20-May,Melbourne,Hangzhou,China,0,0,0,2020,5
20-May,Melbourne,Hong Kong,Hong Kong (SAR),24,129,153,2020,5
20-May,Melbourne,Honolulu,USA,0,0,0,2020,5
20-May,Melbourne,Jakarta,Indonesia,233,482,715,2020,5
20-May,Melbourne,Kuala Lumpur,Malaysia,72,191,263,2020,5
20-May,Melbourne,London,UK,514,190,704,2020,5
20-May,Melbourne,Los Angeles,USA,252,188,440,2020,5
20-May,Melbourne,Manila,Philippines,333,91,424,2020,5
20-May,Melbourne,New Delhi,India,571,894,1465,2020,5
20-May,Melbourne,New York,USA,0,0,0,2020,5
20-May,Melbourne,San Francisco,USA,0,0,0,2020,5
20-May,Melbourne,Shanghai,China,0,0,0,2020,5
20-May,Melbourne,Shenzhen,China,0,0,0,2020,5
20-May,Melbourne,Singapore,Singapore,0,0,0,2020,5
20-May,Melbourne,Taipei,Taiwan,38,748,786,2020,5
20-Jun,Melbourne,Abu Dhabi,United Arab Emirates,92,261,353,2020,6
20-Jun,Melbourne,Anchorage,USA,0,0,0,2020,6
20-Jun,Melbourne,Auckland,New Zealand,1344,1594,2938,2020,6
20-Jun,Melbourne,Bandar Seri Begawan,Brunei,16,72,88,2020,6
20-Jun,Melbourne,Bangkok,Thailand,23,200,223,2020,6
20-Jun,Melbourne,Chicago,USA,0,0,0,2020,6
20-Jun,Melbourne,Christchurch,New Zealand,0,0,0,2020,6
20-Jun,Melbourne,Cincinnati,USA,0,0,0,2020,6
20-Jun,Melbourne,Colombo,Sri Lanka,297,98,395,2020,6
20-Jun,Melbourne,Doha,Qatar,2278,4248,6526,2020,6
20-Jun,Melbourne,Dubai,United Arab Emirates,607,476,1083,2020,6
20-Jun,Melbourne,Guangzhou,China,0,0,0,2020,6
20-Jun,Melbourne,Hong Kong,Hong Kong (SAR),202,335,537,2020,6
20-Jun,Melbourne,Honolulu,USA,0,0,0,2020,6
20-Jun,Melbourne,Jakarta,Indonesia,145,206,351,2020,6
20-Jun,Melbourne,Kuala Lumpur,Malaysia,68,101,169,2020,6
20-Jun,Melbourne,London,UK,198,62,260,2020,6
20-Jun,Melbourne,Los Angeles,USA,117,111,228,2020,6
20-Jun,Melbourne,New Delhi,India,582,947,1529,2020,6
20-Jun,Melbourne,New York,USA,0,0,0,2020,6
20-Jun,Melbourne,San Francisco,USA,0,0,0,2020,6
20-Jun,Melbourne,Santiago,Chile,273,89,362,2020,6
20-Jun,Melbourne,Shanghai,China,0,0,0,2020,6
20-Jun,Melbourne,Singapore,Singapore,123,326,449,2020,6
20-Jun,Melbourne,Taipei,Taiwan,66,330,396,2020,6
20-Jun,Melbourne,Tokyo,Japan,0,0,0,2020,6
