21-Jan,Melbourne,Abu Dhabi,United Arab Emirates,935,662,1597,2021,1
21-Jan,Melbourne,Anchorage,USA,0,0,0,2021,1
21-Jan,Melbourne,Auckland,New Zealand,2052,1104,3156,2021,1
21-Jan,Melbourne,Bandar Seri Begawan,Brunei,24,32,56,2021,1
21-Jan,Melbourne,Bangkok,Thailand,0,0,0,2021,1
21-Jan,Melbourne,Chicago,USA,0,0,0,2021,1
21-Jan,Melbourne,Christchurch,New Zealand,0,0,0,2021,1
21-Jan,Melbourne,Cincinnati,USA,0,0,0,2021,1
21-Jan,Melbourne,Colombo,Sri Lanka,197,1484,1681,2021,1
21-Jan,Melbourne,Doha,Qatar,1038,1347,2385,2021,1
21-Jan,Melbourne,Dubai,United Arab Emirates,413,1320,1733,2021,1
21-Jan,Melbourne,Guangzhou,China,96,1762,1858,2021,1
21-Jan,Melbourne,Hanoi,Vietnam,0,0,0,2021,1
21-Jan,Melbourne,Ho Chi Minh City,Vietnam,0,0,0,2021,1
21-Jan,Melbourne,Hong Kong,Hong Kong (SAR),337,282,619,2021,1
21-Jan,Melbourne,Honolulu,USA,0,0,0,2021,1
21-Jan,Melbourne,Jakarta,Indonesia,96,215,311,2021,1
21-Jan,Melbourne,Kuala Lumpur,Malaysia,141,539,680,2021,1
21-Jan,Melbourne,Los Angeles,USA,147,0,147,2021,1
21-Jan,Melbourne,Manila,Philippines,31,33,64,2021,1
21-Jan,Melbourne,Nadi,Fiji,15,66,81,2021,1
21-Jan,Melbourne,New York,USA,0,0,0,2021,1
21-Jan,Melbourne,Shanghai,China,0,0,0,2021,1
21-Jan,Melbourne,Singapore,Singapore,1167,1301,2468,2021,1
21-Jan,Melbourne,Taipei,Taiwan,64,193,257,2021,1
21-Jan,Melbourne,Tokyo,Japan,0,0,0,2021,1
21-Jan,Melbourne,Vancouver,Canada,0,0,0,2021,1
21-Feb,Melbourne,Abu Dhabi,United Arab Emirates,245,353,598,2021,2
21-Feb,Melbourne,Anchorage,USA,0,0,0,2021,2
21-Feb,Melbourne,Auckland,New Zealand,1488,791,2279,2021,2
21-Feb,Melbourne,Bandar Seri Begawan,Brunei,4,18,22,2021,2
21-Feb,Melbourne,Bangkok,Thailand,0,0,0,2021,2
21-Feb,Melbourne,Chicago,USA,0,0,0,2021,2
21-Feb,Melbourne,Christchurch,New Zealand,0,0,0,2021,2
21-Feb,Melbourne,Cincinnati,USA,0,0,0,2021,2
21-Feb,Melbourne,Colombo,Sri Lanka,85,1003,1088,2021,2
21-Feb,Melbourne,Doha,Qatar,402,1526,1928,2021,2
21-Feb,Melbourne,Dubai,United Arab Emirates,177,1201,1378,2021,2
21-Feb,Melbourne,Guangzhou,China,46,1577,1623,2021,2
21-Feb,Melbourne,Hanoi,Vietnam,0,0,0,2021,2
21-Feb,Melbourne,Ho Chi Minh City,Vietnam,0,0,0,2021,2
21-Feb,Melbourne,Hong Kong,Hong Kong (SAR),77,171,248,2021,2
21-Feb,Melbourne,Honolulu,USA,0,0,0,2021,2
21-Feb,Melbourne,Jakarta,Indonesia,48,123,171,2021,2
21-Feb,Melbourne,Kuala Lumpur,Malaysia,69,142,211,2021,2
21-Feb,Melbourne,Los Angeles,USA,0,0,0,2021,2
21-Feb,Melbourne,New York,USA,0,0,0,2021,2
21-Feb,Melbourne,Shanghai,China,0,0,0,2021,2
21-Feb,Melbourne,Singapore,Singapore,458,1158,1616,2021,2
21-Feb,Melbourne,Taipei,Taiwan,20,59,79,2021,2
21-Feb,Melbourne,Tokyo,Japan,0,0,0,2021,2
21-Feb,Melbourne,Vancouver,Canada,0,0,0,2021,2
21-Mar,Melbourne,Abu Dhabi,United Arab Emirates,0,340,340,2021,3
21-Mar,Melbourne,Anchorage,USA,0,0,0,2021,3
21-Mar,Melbourne,Auckland,New Zealand,1794,928,2722,2021,3
21-Mar,Melbourne,Bandar Seri Begawan,Brunei,0,8,8,2021,3
21-Mar,Melbourne,Bangkok,Thailand,0,0,0,2021,3
21-Mar,Melbourne,Chicago,USA,0,0,0,2021,3
21-Mar,Melbourne,Christchurch,New Zealand,0,0,0,2021,3
21-Mar,Melbourne,Cincinnati,USA,0,0,0,2021,3
21-Mar,Melbourne,Colombo,Sri Lanka,0,773,773,2021,3
21-Mar,Melbourne,Doha,Qatar,0,1121,1121,2021,3
21-Mar,Melbourne,Dubai,United Arab Emirates,0,1200,1200,2021,3
21-Mar,Melbourne,Guangzhou,China,0,1976,1976,2021,3
21-Mar,Melbourne,Hanoi,Vietnam,0,0,0,2021,3
21-Mar,Melbourne,Ho Chi Minh City,Vietnam,0,220,220,2021,3
21-Mar,Melbourne,Hong Kong,Hong Kong (SAR),0,0,0,2021,3
21-Mar,Melbourne,Honolulu,USA,0,0,0,2021,3
21-Mar,Melbourne,Jakarta,Indonesia,0,101,101,2021,3
21-Mar,Melbourne,Kuala Lumpur,Malaysia,0,210,210,2021,3
21-Mar,Melbourne,Los Angeles,USA,0,0,0,2021,3
21-Mar,Melbourne,Manila,Philippines,0,0,0,2021,3
21-Mar,Melbourne,New York,USA,0,0,0,2021,3
21-Mar,Melbourne,Shanghai,China,0,0,0,2021,3
21-Mar,Melbourne,Singapore,Singapore,4,1188,1192,2021,3
21-Mar,Melbourne,Taipei,Taiwan,0,88,88,2021,3
21-Mar,Melbourne,Tokyo,Japan,0,0,0,2021,3
21-Mar,Melbourne,Vancouver,Canada,0,0,0,2021,3
21-Apr,Melbourne,Abu Dhabi,United Arab Emirates,325,398,723,2021,4
21-Apr,Melbourne,Auckland,New Zealand,5900,7049,12949,2021,4
21-Apr,Melbourne,Bandar Seri Begawan,Brunei,15,13,28,2021,4
21-Apr,Melbourne,Bangkok,Thailand,0,0,0,2021,4
21-Apr,Melbourne,Chicago,USA,0,0,0,2021,4
21-Apr,Melbourne,Christchurch,New Zealand,1038,1586,2624,2021,4
21-Apr,Melbourne,Cincinnati,USA,0,0,0,2021,4
21-Apr,Melbourne,Colombo,Sri Lanka,96,721,817,2021,4
21-Apr,Melbourne,Doha,Qatar,577,1011,1588,2021,4
21-Apr,Melbourne,Dubai,United Arab Emirates,292,990,1282,2021,4
21-Apr,Melbourne,Guangzhou,China,81,1425,1506,2021,4
21-Apr,Melbourne,Hanoi,Vietnam,0,0,0,2021,4
21-Apr,Melbourne,Ho Chi Minh City,Vietnam,0,0,0,2021,4
21-Apr,Melbourne,Hong Kong,Hong Kong (SAR),169,0,169,2021,4
21-Apr,Melbourne,Honolulu,USA,0,0,0,2021,4
21-Apr,Melbourne,Jakarta,Indonesia,0,0,0,2021,4
21-Apr,Melbourne,Kuala Lumpur,Malaysia,0,0,0,2021,4
21-Apr,Melbourne,Los Angeles,USA,0,0,0,2021,4
21-Apr,Melbourne,Manila,Philippines,23,13,36,2021,4
21-Apr,Melbourne,New York,USA,0,0,0,2021,4
21-Apr,Melbourne,Queenstown,New Zealand,292,535,827,2021,4
21-Apr,Melbourne,Shanghai,China,0,0,0,2021,4
21-Apr,Melbourne,Singapore,Singapore,632,1350,1982,2021,4
21-Apr,Melbourne,Taipei,Taiwan,16,103,119,2021,4
21-Apr,Melbourne,Tokyo,Japan,0,0,0,2021,4
21-Apr,Melbourne,Vancouver,Canada,0,0,0,2021,4
21-Apr,Melbourne,Wellington,New Zealand,919,1576,2495,2021,4
21-May,Melbourne,Abu Dhabi,United Arab Emirates,522,316,838,2021,5
21-May,Melbourne,Anchorage,USA,0,0,0,2021,5
21-May,Melbourne,Auckland,New Zealand,14822,12430,27252,2021,5
21-May,Melbourne,Bandar Seri Begawan,Brunei,14,10,24,2021,5
21-May,Melbourne,Bangkok,Thailand,0,0,0,2021,5
21-May,Melbourne,Can Tho,Vietnam,0,188,188,2021,5
21-May,Melbourne,Chicago,USA,0,0,0,2021,5
21-May,Melbourne,Christchurch,New Zealand,3105,3066,6171,2021,5
21-May,Melbourne,Cincinnati,USA,0,0,0,2021,5
21-May,Melbourne,Colombo,Sri Lanka,225,58,283,2021,5
21-May,Melbourne,Doha,Qatar,845,1055,1900,2021,5
21-May,Melbourne,Dubai,United Arab Emirates,262,697,959,2021,5
21-May,Melbourne,Guangzhou,China,83,1277,1360,2021,5
21-May,Melbourne,Hanoi,Vietnam,0,0,0,2021,5
21-May,Melbourne,Ho Chi Minh City,Vietnam,0,0,0,2021,5
21-May,Melbourne,Hong Kong,Hong Kong (SAR),243,164,407,2021,5
21-May,Melbourne,Honolulu,USA,0,0,0,2021,5
21-May,Melbourne,Jakarta,Indonesia,50,57,107,2021,5
21-May,Melbourne,Kuala Lumpur,Malaysia,38,155,193,2021,5
21-May,Melbourne,Los Angeles,USA,0,0,0,2021,5
21-May,Melbourne,Manila,Philippines,52,32,84,2021,5
21-May,Melbourne,New York,USA,0,0,0,2021,5
21-May,Melbourne,Queenstown,New Zealand,1109,864,1973,2021,5
21-May,Melbourne,Shanghai,China,0,0,0,2021,5
21-May,Melbourne,Singapore,Singapore,1054,1376,2430,2021,5
21-May,Melbourne,Taipei,Taiwan,0,0,0,2021,5
21-May,Melbourne,Tokyo,Japan,90,0,90,2021,5
21-May,Melbourne,Vancouver,Canada,0,0,0,2021,5
21-May,Melbourne,Wellington,New Zealand,3218,2911,6129,2021,5
21-Jun,Melbourne,Abu Dhabi,United Arab Emirates,520,365,885,2021,6
21-Jun,Melbourne,Auckland,New Zealand,5115,5626,10741,2021,6
21-Jun,Melbourne,Bandar Seri Begawan,Brunei,18,11,29,2021,6
21-Jun,Melbourne,Bangkok,Thailand,0,0,0,2021,6
21-Jun,Melbourne,Chicago,USA,0,0,0,2021,6
21-Jun,Melbourne,Christchurch,New Zealand,722,1210,1932,2021,6
21-Jun,Melbourne,Cincinnati,USA,0,0,0,2021,6
21-Jun,Melbourne,Colombo,Sri Lanka,164,45,209,2021,6
21-Jun,Melbourne,Doha,Qatar,786,1302,2088,2021,6
21-Jun,Melbourne,Dubai,United Arab Emirates,391,854,1245,2021,6
21-Jun,Melbourne,Guangzhou,China,106,1438,1544,2021,6
21-Jun,Melbourne,Hanoi,Vietnam,0,0,0,2021,6
21-Jun,Melbourne,Ho Chi Minh City,Vietnam,0,0,0,2021,6
21-Jun,Melbourne,Hong Kong,Hong Kong (SAR),308,344,652,2021,6
21-Jun,Melbourne,Honolulu,USA,0,0,0,2021,6
21-Jun,Melbourne,Jakarta,Indonesia,29,42,71,2021,6
21-Jun,Melbourne,Kuala Lumpur,Malaysia,60,55,115,2021,6
21-Jun,Melbourne,Los Angeles,USA,0,0,0,2021,6
21-Jun,Melbourne,Manila,Philippines,57,20,77,2021,6
21-Jun,Melbourne,New York,USA,0,0,0,2021,6
21-Jun,Melbourne,Queenstown,New Zealand,642,902,1544,2021,6
21-Jun,Melbourne,Shanghai,China,0,0,0,2021,6
21-Jun,Melbourne,Singapore,Singapore,1110,1432,2542,2021,6
21-Jun,Melbourne,Taipei,Taiwan,0,0,0,2021,6
21-Jun,Melbourne,Tokyo,Japan,65,0,65,2021,6
21-Jun,Melbourne,Vancouver,Canada,0,0,0,2021,6
21-Jun,Melbourne,Wellington,New Zealand,520,856,1376,2021,6
